CONST_MAP_STRING = `
10000000000000000000000000000000000000000000000000000000000000000000000000000000000000000000000000000000000000000000000000000001
00000000000000000000000000000000000000000000000000000000000000000000000000000000000000000000000000000000000000000000000000000000
00000000000000000000000000000000000000000000000000000000000000000000000000000000000000000000000000000000000000000000000000000000
00000000000000000000000000000000011133311111113333333331000000000000000000000000000000000000000000000000000000000000000000000000
00000000000000000000000000000001111300011333333333333333100000000000110000000000000000000000000000000000000000000000000000000000
00000000000000000000001100000001001000000000333333333333100000000000000000000000000000000000011111111111000000000110000000000001
10000000000000000000111110000010011100000000133333333311000000000000000000000000000000011111111222222211111111111111111000000001
00000011111111111111100111110010011001100000011333333311000000000000001111111000010111111122111122222222222222112211111111111111
11100111142244111441114111111111111001121000012333310000000000000000011111111111111111241124111111114111111112222211111411121222
00000111111121112211111112221221100000111000001330000000111000000001111111111111111111111411111111111111111111111222111211241211
00000111111111111111111141411410000011110000000100000000000000000014411111111111111111111111111111111111111111111112111011111010
00000001110000011111111111111110000012211100000000000000000000100011111111111111111111111111111111111111111111111100000111000000
00000000000000000111111111111111111011111210000000000000000001110011111111111111121111111111111111111111111111111000000111000000
00000000000000000011111111111111111111111141000000000000000011111111111111111111111112222222111111111111111111111110000110000000
00000000000000000001111122111111111111111101100000000000000000111112111111111111222222222222221122111111211111111110000000000000
00000000000000000000121122221111111111111100000000000000000000012211111112111122211222222222222222222222221111111000000000000000
00000000000000000000122122222111111111111100000000000000000001111111111111000011111222222222222222222222221111110010000000000000
00000000000000000000122222222111111111100000000000000000000012221000101111111111100222222222222222222222211111000110000000000000
00000000000000000000122222222111111111000000000000000000000002210000000101222222210222222222222222222222111111001100000000000000
00000000000000000000012222222211111110000000000000000000000000111221000000001222221222222112222222222221111011011100000000000000
00000000000000000000001222222211111100000000000000000000000002222222100010001222222222222212222222111111121000100000000000000000
00000000000000000000000112222111111100000000000000000000000012222222221221112222112222222111112222111111111100000000000000000000
00000000000000000000000011221100000100000000000000000000000122222222222222221222210111222222121111141111111000000000000000000000
00000000000000000000000000122100000000000000000000000000001222222222222222221122221210012222222111111111111000000000000000000000
00000000000000000000000000112100100110000000000000000000001222222222222222221012222210001121111111111111000000000000000000000000
00000000000000000000000000011111100000000000000000000000001222222222222222222112222100000121110001111100000000000000000000000000
00000000000000000000000000000011111000000000000000000000001222222222222222222101220000000012100000111100001000000000000000000000
00000000000000000000000000000000011000000000000000000000001111211212222122211121000000000012000000111110000100000000000000000000
00000000000000000000000000000000011001111110000000000000001111111111111111111121210000000001100000000100000110000000000000000000
00000000000000000000000000000000000011111111100000000000000111111111111111111122200000000000100000010000000010000000000000000000
00000000000000000000000000000000000011111111110000000000000000000011111111112222100000000000000000111000110000000000000000000000
00000000000000000000000000000000000011111111111000000000000000000001111111112221000000000000000000011001110100000000000000000000
00000000000000000000000000000000000111111111111110000000000000000001111111112210000000000000000000011011111100111000000000000000
00000000000000000000000000000000000111111111111111100000000000000000111111111100000000000000000000001100000000001111000000000000
00000000000000000000000000000000000111111111111111110000000000000000111111111100000000000000000000000111000000000111000000000000
00000000000000000000000000000000000011111111111111110000000000000000011111111100000000000000000000000000000000000000100000000000
00000000000000000000000000000000000001111111111111100000000000000000111111111110000000000000000000000000000001110110000000000000
00000000000000000000000000000000000001121111111111100000000000000000111111111100110000000000000000000000000011111010000000000000
00000000000000000000000000000000000000022111111111000000000000000000122111211001110000000000000000000000000222222121000000000000
00000000000000000000000000000000000000012111111111000000000000000000122222211001100000000000000000000000122222222222100000000000
00000000000000000000000000000000000000022111111100000000000000000000012222110001100000000000000000000000222222222222210000000000
00000000000000000000000000000000000000022111111000000000000000000000012222110000000000000000000000000000122222222222210000000000
00000000000000000000000000000000000000122111111000000000000000000000002222100000000000000000000000000000122222222222210000000000
00000000000000000000000000000000000000122111110000000000000000000000001211000000000000000000000000000000011100012222210000000000
00000000000000000000000000000000000000122221100000000000000000000000000000000000000000000000000000000000000000000222100000000000
00000000000000000000000000000000000000122211000000000000000000000000000000000000000000000000000000000000000000000011000000000110
00000000000000000000000000000000000000122100000000000000000000000000000000000000000000000000000000000000000000000001100000001101
00000000000000000000000000000000000000121000000000000000000000000000000000000000000000000000000000000000000000000000000000011000
00000000000000000000000000000000000000220000000000000000000000000000000000000000000000000000000000000000000000000000000000010000
00000000000000000000000000000000000001210000000000000000000000000000000000000000000000000000000000000000000000000000000000000000
00000000000000000000000000000000000000110000000000000000000000000000000000000000000000000000000000000000000000000000000000000000
00000000000000000000000000000000000000010000000000000000000000000000000000000000000000000000000000000000000000000000000000000000
00000000000000000000000000000000000000000000000000000000000000000000000000000000000000000000000000000000000000000000000000000000
00000000000000000000000000000000000000000000000000000000000000000000000000000000000000000000000000000000000000000000000000000000
00000000000000000000000000000000000000000000000000000000000000000000000000000000000000000000000000000000000000000000000000000001
00000000000000000000000000000000000000000300000000000000000000000000000000000000001100000000001111333111111131133110000000000000
00000000000000000000000000000000000000113310000000000000000000000000000000011013333333333311333333333333333333333333333101000000
00000000000000000000000000001111110001333300000000000000001333333333333333333333333333333333333333333333333333333333333333100001
00000000000113333333333333333333333333333310000000000003333333333333333333333333333333333333333333333333333333333333333331100000
10000000333333333333333333333333333333333333333111113333333333333333333333333333333333333333333333333333333333333333333332131111
23333333333333333333333333333333333333333333333333333333333333333333333333333333333333333333333333333333333333333333333313333332
13333333333333333333333333333333333333333333333333333333333333333333333333333333333333333333333333333333333333333333333333113331
13333333333333333333333333333333333333333333333333333333333333333333333333333333333333333333333333333333333333333333333333333331
12211111111222222221112111111112222111111111221211112111111111111111111111112221111111111111222211111111111111111111111111211222
`;
